{
	"pos": [
		[ 1, 4, 4, 5, 4, 4, 1, 1, 1, 1 ],
		[ 1, 0, 0, 0, 0, 2, 0, 0, 0, 1 ],
		[ 1, 0, 0, 0, 0, 0, 0, 0, 0, 1 ],
		[ 1, 0, 0, 0, 0, 0, 0, 0, 0, 1 ],
		[ 1, 0, 0, 0, 0, 0, 0, 0, 0, 1 ],
		[ 1, 0, 0, 0, 7, 6, 0, 0, 0, 1 ],
		[ 1, 0, 0, 0, 0, 0, 0, 0, 0, 1 ],
		[ 1, 0, 0, 0, 0, 0, 0, 0, 0, 1 ],
		[ 1, 3, 0, 0, 0, 0, 0, 0, 0, 1 ],
		[ 1, 1, 1, 1, 1, 1, 1, 1, 1, 1 ]
	]
}