{
	"pos": [
		[ 1, 4, 4, 4, 4, 4, 1, 1, 1, 1 ],
		[ 1, 0, 0, 0, 0, 2, 0, 0, 0, 1 ],
		[ 1, 0, 0, 0, 0, 0, 0, 0, 0, 1 ],
		[ 1, 0, 0, 0, 0, 0, 0, 0, 0, 1 ],
		[ 6, 0, 0, 0, 0, 0, 0, 0, 0, 1 ],
		[ 1, 0, 0, 0, 7, 8, 0, 0, 0, 1 ],
		[ 1, 0, 0, 0, 0, 0, 0, 0, 0, 1 ],
		[ 5, 0, 0, 0, 0, 0, 0, 0, 0, 1 ],
		[ 5, 0, 0, 0, 0, 0, 0, 0, 0, 1 ],
		[ 5, 0, 0, 0, 0, 0, 0, 0, 0, 1 ],
		[ 5, 0, 0, 0, 0, 0, 0, 0, 0, 1 ],
		[ 5, 0, 0, 0, 0, 0, 0, 0, 0, 1 ],
		[ 5, 3, 0, 0, 0, 0, 0, 0, 0, 1 ],
		[ 1, 1, 1, 1, 1, 1, 1, 1, 1, 1 ]
	]
}